6 10
|--------|
|...|..P.|
|........|
|FF...@|.|
|..F...|.|
|--------|